 ---------------------
|        * i *        |
|                     |
|        *   *        |
|                     |
|        *   *        |
|                     |
|        *   *        |
|                     |
|          E          |
 ---------------------                    